num,A,B,C,D,E,F,G,H,I
1,18,0,0,0,0,0,0,0,11
2,3,0,0,14,0,0,0,0,0
3,0,0,8,0,0,0,0,0,0
4,0,0,2,0,0,0,0,0,0
5,0,0,0,0,0,0,0,0,0
6,0,0,0,0,0,0,0,0,3
7,0,0,0,0,0,0,0,0,0
8,0,0,0,0,0,0,0,0,0
9,0,0,9,0,0,0,0,0,0
